NO textures/simonkraft/wet_sponge.xpm
SO textures/simonkraft/wet_sponge.xpm
WE textures/simonkraft/wet_sponge.xpm
EA textures/simonkraft/wet_sponge.xpm

F 164,169,20
C 153,204,255


111111111111111
111111000111111
111110000011111
111100000001111
111000000000111
110000000000011
1000000N0000001
110000000000011
111000000000111
111100000001111
111110000011111
111111000111111
111111111111111