NO textures/simonkraft/wet_sponge.xpm
SO textures/simonkraft/wet_sponge.xpm
WE textures/simonkraft/wet_sponge.xpm
EA textures/simonkraft/wet_sponge.xpm

F 164,169,20
C 153,204,255


111111111111111
111111000111111  11111111
111110000011111  10000001
111100000001111  10000001
111000000000111  10000001
110000000000011  10000001
100000000000001  11111111
110000000000011
111000000000111
111100000001111
111110000011111
1111110N0111111
111111111111111