NO textures/test/north.xpm
SO textures/test/south.xpm
WE textures/test/west.xpm
EA textures/test/east.xpm

F 20,20,20
C 200,200,200

111111
100001    111
100001    101
100001    111
100001
100001
110001
10000S
100001
100001
100001
100001
111111
