

NO textures/bipbip.xpm
SO textures/coyote.xpm
EA textures/taz.xpm
WE textures/speedy.xpm

C                                       153,                      204                             ,                255       
F 164,255    ,200

    11111111 111111
111111101111111
111111000111111      11111111
111110000011111      10000001
111100000001111      10000001
111000000000111      10000001
110000000000011      10000001
100000000000001      11111111
1101N1000000011
111111000000111
111100000001111
111110000011111
111111000111111
111111101111111
111111111111  11111111