
C                                       153,                      204                             ,                255       

NO textures/north.xpm
SO textures/coyote.xpm
EA textures/speedy.xpm
WE textures/taz.xpm

F 164,255    ,200           
    11111111 111
111111101111111
111111000111111      11111111
111110000011111      10000001
111100000001111      10000001
111000000000111      10000001
1100000000000011      10000001
100000000000001     111111111
110101000000011
111111000000111
111100000001111
111110000011111
111111000111111
1111111101111101     1   
111111111111  1111111S1
                     1          




